20
 - - - - - - - - - - - - - - - - - -0- +
 - - - - - - - - - - - - - - - - - - - +
 - - - - - - - - - - - - - - - - - - - +
 - - - - - - - - - - - - - - - - - - - +
 - - - - - - - - - - - - - - - - - - - +
 - - - - - - - - - - - - - - - - - - - +
 - - - - - - - - - - - - - - - - - - - +
 - - - - - - - - - - - - - - - - - - - +
 - - - - - - - - - - - - - - - - - - - +
 - - - - - - - - - - - - - - - - - - -#-
 - - - - - - - - - - - - - - - - - - -#-
 - - - - - - - - - - - - - - - - - - -#-
 - - - - - - - - - - - - - - - - - - -#-
 - - - - - - - - - - - - - - - - - - -#-
 - - - - - - - - - - - - - - - - - - -#-
 - - - - - - - - - - - - - - - - - - -#-
 - - - - - - - - - - - - - - - - - - -#-
 - - - - - - - - - - - - - - - - - - -#-
 - - - - - - - - - - - - - - - - - - -#-
#- - - - - - - - - - - - - - - - - - -#-
