EEEEEEEEE
EBEEEBBBE
EBEEBEBBE
EEBXBEBBE
EEEEBBBBE
EBEEBEEBE
EEEEBBEEE
EBEEEEEBE
EEEEEEEEE
