20
 + + + + + + + + + + + + + + + + + + + +
 + - - - - - - - - - - - - - - - - - - +
 + - - - - - - - - - - - - - - - - - - +
 + - -#-#-#-#- - +#-#- + -#-#-#-#- - - +
 + - -#-#- - - - -#-#- - - - -#-#- - - +
 + - -#- - - - - -#-#- - - - - -#- - - +
 + - -#- - - - - - + + - - - - -#- - - +
 + - - - - - - - -#-#- - - - - - - - - +
 + - - + - - - - -#-#- - - - - - + - - +
 + - -#-#-#- +#-#-#-#-#-#- +#-#-#- - - +
 + - -#-#-#- +#-#-#-#-#-#- +#-#-#- - - +
 + - - + - - - - -#-#- - - - - - + - - +
 + - - - - - - - -#-#- - - - - - - - - +
 + - -#- - - - - - + + - - - - -#- - - +
 + - -#- - - - - -#-#- - - - - -#- - - +
 + - -#-#- - - - -#-#- - - - -#-#- - - +
 + - -#-#-#-#- - +#-#- + -#-#-#-#- - - +
 + - - - - - - - - - - - - - - - - - - +
0+ - - - - - - - - - - - - - - - - - - +
 + + + + + + + + + + + + + + + + + + + +
