20
 - - + + + + + + +#-#- + + + + + + + - -
 -#-#- - - - - - - - - - - - - - -#-#- -
 +#-#- - - - - +#-#-#-#- + - - - -#-#- +
 + - - - - - - - -#-#- - - - - - - - - +
 + - - - - - - - -#-#- - - - - - - - - +
 + - - - - - - - -#-#- - - - - - - - - +
 + - - - - -#-#- +#-#- +#-#- - - - - - +
 + - - - - -#-#- - - - -#-#- - - - - - +
 + - - - - -#-#- - - - -#-#- - - - - - +
#- - -#- - - + + - - - - + + - -#- - -#-
#- - -#- - - + + - - - - + + - -#- - -#-
 + - - - - -#-#- - - - -#-#- - - - - - +
 + - - - - -#-#- - - - -#-#- - - - - - +
 + - - - - -#-#- + - - +#-#- - - - - - +
 + - - - - - - - -#-#- - - - - - - - - +
 + - - - - - - - -#-#- - - - - - - - - +
 + - - - - - - - -#-#- - - - - - - - - +
 +#-#- - - - -0+#-#-#-#- + - - - -#-#- +
 -#-#- - - - - - - - - - - - - - -#-#- -
 - - + + + + + + +#-#- + + + + + + + - -
