EEEEEEEEE
EBBBBBBBE
EBBBBBBBE
EBBBBBBBE
EBBBBBBBE
EBBBBBBBE
EBBBBBBBE
EBBBBBXBE
EEEEEEEEE
