EEEEEEEEE
EBEEEBEBE
EBEEBEEBE
EEBXBEBEE
EEEEBBBBE
EBEEBEEBE
EEEEBBEEE
EBEEEEEBE
EEEEEEEEE
